Port,TCP/UDP,Probe,Open,Open/Reset,Open/Timeout,Closed/Reset,Timeout,Total
0,_SUMS_,_SUMS_,1516223500,1295050170,2384671240,54350488280,119709280000,179255713190
80,TCP,GetRequest,173710000,14270000,51590000,20990000,360340000,620900000
443,TCP,SSLSessionReq,77520000,5350000,13610000,72480000,326930000,495890000
21,TCP,GetRequest,70280000,10590000,12980000,25940000,377950000,497740000
80,TCP,HTTPOptions,56240000,10360000,34030000,46170000,103490000,250290000
80,TCP,FourOhFourRequest,56050000,6400000,5720000,46640000,103500000,218310000
80,TCP,crossdomainxml,55080000,5270000,35070000,7330000,115780000,218530000
23,TCP,GenericLines,53600000,10240000,5000000,22980000,357170000,448990000
80,TCP,RTSPRequest,53330000,10700000,31380000,47750000,100470000,243630000
53,UDP,DNSStatusRequest,47050000,0,0,343850000,0,390900000
25,TCP,Hello,44130000,9020000,26990000,79330000,344060000,503530000
161,UDP,SNMPv3GetRequest,34020000,0,0,117520000,0,151540000
53,UDP,DNSVersionBindReq,34010000,0,0,213340000,0,247350000
443,TCP,GetRequest,33470000,25800000,25300000,66180000,314300000,465050000
80,TCP,X11Probe,33430000,12220000,114560000,82770000,206300000,449280000
443,TCP,SSLv23SessionReq,28620000,1470000,5030000,60190000,110780000,206090000
8080,TCP,GetRequest,28490000,3990000,6840000,51610000,329170000,420100000
25,TCP,GetRequest,28210000,5390000,16200000,16280000,240640000,306720000
4567,TCP,GetRequest,26300000,1800000,2740000,17170000,230900000,278910000
53,TCP,DNSStatusRequest,22630000,11130000,8590000,79940000,381140000,503430000
21,TCP,SSLSessionReq,22290000,3260000,5290000,6920000,103820000,141580000
53,TCP,DNSVersionBindReq,20150000,7890000,6130000,23200000,327810000,385180000
23,TCP,GetRequest,18530000,3590000,2150000,6480000,102640000,133390000
21,TCP,Help,18240000,3300000,3310000,44210000,83710000,152770000
21,TCP,GenericLines,17940000,3020000,4780000,5950000,83300000,114990000
22,TCP,SSLSessionReq,16300000,18670000,3210000,14760000,224050000,276990000
143,TCP,GetRequest,15660000,3230000,12360000,22940000,317380000,371570000
5060,UDP,SIPOptions,14830000,0,0,127190000,0,142020000
25,TCP,Help,13730000,3450000,9050000,40670000,87010000,153910000
5060,TCP,SIPOptions,13660000,1540000,13230000,79790000,236850000,345070000
8080,TCP,Socks5,12880000,10130000,9270000,133790000,254030000,420100000
993,TCP,SSLSessionReq,12800000,2150000,6990000,66150000,313500000,401590000
23,TCP,SSLSessionReq,12170000,2210000,1300000,4230000,67100000,87010000
110,TCP,GenericLines,12010000,3010000,9320000,15380000,215040000,254760000
3389,TCP,TerminalServer,10350000,1820000,2820000,71210000,226140000,312340000
143,TCP,SSLSessionReq,10140000,2160000,7100000,15270000,214850000,249520000
161,UDP,SNMPv1public,9230000,0,0,122720000,0,131950000
22,TCP,GetRequest,9000000,9470000,2100000,6960000,109460000,136990000
443,TCP,vmware-esx,8680000,22760000,23310000,129660000,239440000,423850000
8080,TCP,RTSPRequest,8620000,3490000,2980000,69640000,122310000,207040000
25,TCP,SSLSessionReq,8470000,3070000,5200000,2890000,45700000,65330000
8080,TCP,FourOhFourRequest,8220000,3140000,3380000,62070000,112370000,189180000
8081,TCP,GetRequest,7930000,1650000,2420000,40440000,206060000,258500000
443,TCP,HTTPOptions,7540000,10680000,10040000,61980000,118150000,208390000
587,TCP,Hello,7520000,1860000,3620000,15770000,217630000,246400000
135,TCP,SMBProgNeg,7420000,337530,1200000,19090000,274270000,302317530
8080,TCP,HTTPOptions,7290000,4250000,3600000,7950000,106390000,129480000
8085,TCP,GetRequest,6980000,1640000,2650000,53100000,217790000,282160000
110,TCP,GetRequest,6410000,1370000,5030000,7060000,102800000,122670000
111,TCP,RPCCheck,6280000,1420000,3010000,60780000,205800000,277290000
465,TCP,SSLSessionReq,6190000,1890000,4730000,15730000,215510000,244050000
5357,TCP,SSLSessionReq,5890000,1450000,2430000,16490000,216180000,242440000
5060,TCP,GetRequest,5300000,640620,8310000,7350000,106350000,127950620
110,TCP,SSLSessionReq,4570000,1000000,4040000,4970000,73500000,88080000
8085,TCP,FourOhFourRequest,4440000,699130,1760000,71090000,127040000,205029130
993,TCP,SSLv23SessionReq,4200000,926570,2520000,57290000,97750000,162686570
8081,TCP,FourOhFourRequest,4150000,1180000,1860000,56470000,101850000,165510000
111,UDP,RPCCheck,4140000,0,0,133260000,0,137400000
587,TCP,Help,4060000,875590,1950000,7580000,107620000,122085590
587,TCP,GenericLines,4030000,1250000,1900000,7280000,105840000,120300000
554,TCP,RTSPRequest,3640000,5660000,26210000,15640000,212700000,263850000
199,TCP,RPCCheck,3370000,2060000,3860000,76160000,340220000,425670000
49152,TCP,FourOhFourRequest,3250000,718230,5930000,64900000,125900000,200698230
3306,TCP,GetRequest,3090000,8320000,2570000,15610000,214150000,243740000
5357,TCP,GetRequest,3050000,2060000,1800000,8330000,107510000,122750000
81,TCP,GetRequest,2970000,1230000,2800000,15900000,215970000,238870000
8081,TCP,SIPOptions,2880000,951120,1840000,62010000,118370000,186051120
8008,TCP,GetRequest,2720000,1320000,2580000,15950000,214210000,236780000
8000,TCP,FourOhFourRequest,2620000,2450000,4000000,122990000,223450000,355510000
49152,TCP,GetRequest,2610000,488170,4380000,7750000,108320000,123548170
5900,TCP,GetRequest,2550000,3420000,5240000,28260000,318910000,358380000
8000,TCP,GetRequest,2270000,1770000,3640000,27370000,206300000,241350000
2000,TCP,SSLSessionReq,2050000,3310000,2920000,16000000,214820000,239100000
8080,TCP,Socks4,2000000,2640000,11220000,67920000,122250000,206030000
2427,UDP,RPCCheck,1790000,0,0,140830000,0,142620000
81,TCP,FourOhFourRequest,1760000,752980,1970000,69420000,124870000,198772980
443,TCP,X11Probe,1730000,10690000,11400000,41740000,102810000,168370000
3306,TCP,SSLSessionReq,1710000,3760000,1580000,7110000,95620000,109780000
8443,TCP,SSLSessionReq,1710000,659770,1200000,10980000,143130000,157679770
10000,TCP,GetRequest,1640000,2570000,4230000,15220000,202010000,225670000
5000,TCP,GetRequest,1510000,1970000,4080000,15740000,213130000,236430000
6969,TCP,GetRequest,1430000,1180000,2900000,24580000,207220000,237310000
81,TCP,HTTPOptions,1280000,897410,1660000,7400000,103810000,115047410
199,TCP,Socks4,1250000,809900,1610000,59320000,119540000,182529900
9999,TCP,GetRequest,1190000,1910000,3810000,63280000,206140000,276330000
8008,TCP,FourOhFourRequest,1150000,690200,1680000,59360000,112280000,175160200
500,UDP,RPCCheck,1100000,0,0,133770000,0,134870000
199,TCP,GenericLines,1090000,750060,1270000,7460000,104470000,115040060
199,TCP,Socks5,1060000,1010000,1620000,56190000,103150000,163030000
2000,TCP,SSLv23SessionReq,1060000,2080000,1440000,7810000,107310000,119700000
2000,TCP,GetRequest,1030000,2050000,1600000,8110000,105500000,118290000
10000,TCP,HTTPOptions,995330,984120,2700000,67370000,121870000,193919450
8088,TCP,GetRequest,975060,1280000,1570000,49220000,111180000,164225060
10000,TCP,RTSPRequest,969290,1100000,2440000,69440000,121310000,195259290
8088,TCP,Socks5,967130,757290,1830000,66620000,121030000,191204420
444,TCP,SSLSessionReq,965410,1470000,2550000,49690000,203700000,258375410
5900,TCP,SSLSessionReq,952840,1980000,1960000,7750000,104890000,117532840
8000,TCP,Socks5,932200,1520000,2780000,67140000,123510000,195882200
1025,TCP,SMBProgNeg,927130,1100000,2060000,39510000,100810000,144407130
2000,TCP,NCP,904240,1380000,1540000,54760000,107390000,165974240
8888,TCP,HTTPOptions,899630,1410000,2130000,7840000,104010000,116289630
1967,UDP,DNSVersionBindReq,896360,0,0,125980000,0,126876360
139,TCP,SMBProgNeg,879220,143720,397320,3430000,100950000,105800260
5800,TCP,GetRequest,837000,2440000,2810000,15500000,211830000,233417000
8888,TCP,GetRequest,824640,1030000,1940000,50930000,107590000,162314640
9000,TCP,GetRequest,823890,1850000,2210000,56760000,117780000,179423890
10000,TCP,SSLSessionReq,813060,1800000,1980000,7890000,99750000,112233060
8443,TCP,GetRequest,805620,1330000,1850000,44410000,104990000,153385620
5353,UDP,DNS-SD,803250,0,0,133100000,0,133903250
8888,TCP,FourOhFourRequest,794920,785740,1990000,54400000,104190000,162160660
8000,TCP,GenericLines,781020,1010000,2320000,8340000,112030000,124481020
2001,TCP,GetRequest,762610,2240000,3330000,16240000,211960000,234532610
9999,TCP,FourOhFourRequest,750620,882160,2320000,69110000,124550000,197612780
26,TCP,GetRequest,732800,671020,1280000,7320000,101940000,111943820
1433,TCP,ms-sql-s,707630,508590,1140000,57300000,120340000,179996220
26,TCP,SSLSessionReq,705600,956330,1600000,7170000,101050000,111481930
631,TCP,HTTPOptions,679850,691390,1620000,65950000,123740000,192681240
554,TCP,GetRequest,679580,3620000,20420000,7970000,106370000,139059580
5000,TCP,RTSPRequest,672800,1360000,2220000,7470000,102650000,114372800
8880,TCP,FourOhFourRequest,669750,621660,1770000,58340000,110880000,172281410
139,TCP,GetRequest,644770,320160,611180,3870000,99190000,104636110
18182,TCP,SMBProgNeg,641520,675170,1550000,56500000,106270000,165636690
1050,TCP,GetRequest,627660,1600000,1480000,7910000,103400000,115017660
8880,TCP,GetRequest,617560,960730,1570000,45610000,104180000,152938290
9000,TCP,GenericLines,613200,1490000,2130000,8870000,111790000,124893200
631,TCP,GetRequest,605470,560310,1400000,7810000,107430000,117805780
8082,TCP,FourOhFourRequest,601010,1120000,1930000,74220000,124010000,201881010
69,UDP,DNSStatusRequest,599600,0,0,136280000,0,136879600
5432,TCP,SMBProgNeg,595590,609520,1520000,57080000,103380000,163185110
88,TCP,Kerberos,594510,773510,1800000,58300000,113470000,174938020
8009,TCP,ajp,591490,743400,1950000,64750000,122120000,190154890
137,UDP,NBTStat,578280,0,0,70070000,0,70648280
3128,TCP,GetRequest,575050,1160000,1660000,11530000,192650000,207575050
515,TCP,Help,557410,1520000,3370000,74720000,235840000,316007410
5000,TCP,GenericLines,553320,1090000,2300000,8030000,106020000,117993320
1026,TCP,GetRequest,546090,1690000,5250000,14960000,211830000,234276090
81,TCP,RPCCheck,544860,816100,2710000,67580000,123400000,195050960
515,TCP,GetRequest,544520,1610000,2990000,14670000,211120000,230934520
444,TCP,SSLv23SessionReq,532620,590640,1310000,7680000,109130000,119243260
88,TCP,GetRequest,518520,792710,1380000,7790000,106850000,117331230
88,TCP,FourOhFourRequest,517020,910390,1500000,62390000,119280000,184597410
2601,TCP,GetRequest,503140,1850000,1750000,8150000,106450000,118703140
8082,TCP,GetRequest,497120,1030000,1480000,43740000,98620000,145367120
2601,TCP,SSLSessionReq,492490,1900000,1560000,8180000,106380000,118512490
6001,TCP,X11Probe,490400,684590,1620000,73450000,124110000,200354990
106,TCP,GetRequest,475220,766080,1450000,7110000,101690000,111491300
5632,UDP,pc-anywhere,472030,0,0,292210000,0,292682030
389,TCP,LDAPBindReq,465170,1010000,1980000,50380000,92320000,146155170
106,TCP,SSLSessionReq,452470,851620,1260000,6920000,100410000,109894090
1027,TCP,SMBProgNeg,447600,950450,2010000,7810000,110860000,122078050
9001,TCP,SSLv23SessionReq,440450,862650,1970000,73870000,125980000,203123100
5009,TCP,SMBProgNeg,438440,843410,1550000,9250000,108020000,120101850
88,UDP,Kerberos,435870,0,0,144630000,0,145065870
3128,TCP,HTTPOptions,426600,561700,1310000,52750000,117050000,172098300
9090,TCP,GetRequest,408460,867010,1700000,63590000,121190000,187755470
2121,TCP,GetRequest,406540,1230000,1700000,8030000,105320000,116686540
990,TCP,SSLSessionReq,400290,854500,1510000,7490000,105810000,116064790
9001,TCP,GetRequest,394480,1310000,1640000,50960000,106530000,160834480
2049,TCP,RPCCheck,390030,647160,1360000,65630000,112230000,180257190
9001,TCP,SSLSessionReq,385490,1100000,1690000,8200000,108480000,119855490
5190,TCP,GetRequest,383240,2410000,8170000,7650000,104760000,123373240
9001,TCP,GenericLines,382430,1000000,1790000,9100000,112680000,124952430
7,UDP,Help,380030,0,0,149300000,0,149680030
82,TCP,FourOhFourRequest,376280,769790,1660000,72290000,123990000,199086070
515,TCP,LPDString,375810,726360,2040000,65770000,122700000,191612170
82,TCP,HTTPOptions,364480,689280,1720000,59990000,114630000,177393760
88,TCP,SMBProgNeg,361140,874450,1910000,7820000,110790000,121755590
2121,TCP,SSLSessionReq,358280,1110000,1530000,7420000,97320000,107738280
5190,TCP,SSLSessionReq,357340,2510000,8600000,7930000,104440000,123837340
2525,TCP,GetRequest,357270,1230000,1590000,8050000,107330000,118557270
2001,TCP,SSLSessionReq,356480,868370,1600000,8130000,104670000,115624850
8001,TCP,FourOhFourRequest,349920,758070,1740000,64590000,122430000,189867990
8000,TCP,X11Probe,344980,958750,2800000,62530000,122510000,189143730
82,TCP,GetRequest,338740,614890,1440000,7870000,109340000,119603630
1024,TCP,GetRequest,333560,749140,2110000,7470000,105120000,115782700
9100,TCP,hp-pjl,332350,1240000,1920000,69140000,123930000,196562350
2002,TCP,SSLSessionReq,329680,881590,1550000,7350000,96710000,106821270
548,TCP,afp,328600,852640,1500000,55910000,106780000,165371240
445,TCP,SMBProgNeg,326220,25500,74970,5800000,34920000,41146690
3128,TCP,Socks5,326090,1230000,1310000,22580000,103130000,128576090
2002,TCP,GetRequest,324990,1850000,3530000,16070000,211960000,233734990
4001,TCP,GetRequest,321230,1440000,1640000,8110000,105330000,116841230
5000,TCP,SMBProgNeg,320470,1610000,5450000,65090000,217780000,290250470
10000,UDP,RPCCheck,318480,0,0,133460000,0,133778480
5000,TCP,SSLSessionReq,315750,1080000,2470000,7700000,104510000,116075750
4000,TCP,GetRequest,307890,2560000,3590000,16110000,214130000,236697890
548,TCP,SSLSessionReq,305870,733630,1460000,67520000,114600000,184619500
5555,TCP,GenericLines,305840,1190000,1630000,8030000,107010000,118165840
79,TCP,GetRequest,303790,1900000,2720000,15020000,211060000,231003790
12345,TCP,OfficeScan,301220,1320000,1930000,66350000,121640000,191541220
4001,TCP,SSLSessionReq,298770,1120000,1570000,7930000,105420000,116338770
2002,TCP,X11Probe,297420,582480,1330000,52760000,94490000,149459900
123,UDP,NTPRequest,292960,0,0,115240000,0,115532960
8001,TCP,GetRequest,277580,831480,2210000,15250000,100680000,119249060
8083,TCP,GetRequest,257970,937950,1460000,43260000,98970000,144885920
9080,TCP,GetRequest,256220,833280,1840000,60670000,119080000,182679500
1026,TCP,SSLSessionReq,253910,968780,2630000,7190000,103620000,114662690
8083,TCP,FourOhFourRequest,243180,699330,1620000,57480000,110910000,170952510
8008,TCP,Socks5,243010,782670,3030000,63560000,120060000,187675680
5001,TCP,GetRequest,241770,1630000,1740000,7890000,103120000,114621770
2869,TCP,GetRequest,239710,1290000,3780000,7510000,108500000,121319710
666,TCP,GenericLines,238840,901670,1310000,7550000,106570000,116570510
1434,UDP,Sqlping,236470,0,0,92810000,0,93046470
3000,TCP,GetRequest,236060,901660,1680000,8100000,107600000,118517720
548,TCP,SSLv23SessionReq,234880,634070,1520000,26030000,93570000,121988950
1900,TCP,GetRequest,224790,1020000,1550000,7960000,108150000,118904790
7001,UDP,AFSVersionRequest,224430,0,0,136740000,0,136964430
2030,TCP,GetRequest,217070,939040,1690000,7840000,107890000,118576110
2100,TCP,FourOhFourRequest,215660,669050,1560000,64240000,105890000,172574710
50000,TCP,ibm-db2,215630,1670000,4090000,142070000,245490000,393535630
8010,TCP,FourOhFourRequest,214870,4590000,4140000,139510000,244300000,392754870
9999,TCP,HTTPOptions,214030,566310,1390000,42540000,79140000,123850340
6004,TCP,X11Probe,213910,1390000,3200000,131390000,247660000,383853910
1311,TCP,SSLSessionReq,213480,629470,1630000,57180000,106790000,166442950
1311,TCP,GetRequest,204460,870680,1570000,7980000,107770000,118395140
85,TCP,FourOhFourRequest,204070,708950,1700000,67620000,126220000,196453020
113,TCP,GetRequest,197470,718650,1220000,9410000,104980000,116526120
1723,TCP,GetRequest,196360,2520000,3630000,8050000,105160000,119556360
7,TCP,Help,196340,758830,1370000,7920000,108910000,119155170
515,TCP,SSLSessionReq,196010,1030000,1620000,7180000,102920000,112946010
6002,TCP,X11Probe,195030,707780,1450000,63300000,117560000,183212810
1311,TCP,Help,193530,1180000,1630000,7820000,107360000,118183530
3000,TCP,GenericLines,189480,1040000,1550000,7730000,105520000,116029480
18264,TCP,GetRequest,188050,853510,1650000,7710000,105620000,116021560
873,TCP,GetRequest,186880,909650,1330000,7380000,102730000,112536530
8181,TCP,SSLSessionReq,186670,1010000,2030000,8210000,108050000,119486670
9090,TCP,drda,183700,2180000,4650000,135120000,246140000,388273700
8005,TCP,FourOhFourRequest,183230,896090,1710000,61690000,118390000,182869320
9999,TCP,SSLSessionReq,178390,967480,2090000,6750000,87430000,97415870
85,TCP,GetRequest,178310,661010,1420000,7680000,108640000,118579320
8002,TCP,GetRequest,176060,2610000,3610000,22720000,203280000,232396060
1723,TCP,SSLSessionReq,175950,2590000,3290000,7880000,104790000,118725950
1022,TCP,GetRequest,174860,1350000,1330000,7510000,104120000,114484860
50000,TCP,GetRequest,174690,808190,1830000,64230000,121500000,188542880
1025,TCP,GetRequest,174140,1020000,2690000,6700000,103030000,113614140
1311,TCP,SSLv23SessionReq,173970,622510,1480000,62230000,107250000,171756480
113,TCP,GenericLines,172500,1130000,1230000,8970000,101110000,112612500
8181,TCP,GetRequest,169760,685260,1540000,44270000,101320000,147985020
8007,TCP,FourOhFourRequest,169180,806420,1890000,67310000,127460000,197635600
5901,TCP,GetRequest,166510,1160000,1540000,7980000,105680000,116526510
3050,TCP,firebird,165980,701480,1590000,59760000,113310000,175527460
8008,TCP,ajp,164500,1230000,3070000,67940000,119780000,192184500
5800,TCP,SSLSessionReq,159660,1120000,1270000,6370000,88160000,97079660
3000,TCP,Help,159470,1220000,2150000,16570000,99180000,119279470
5222,TCP,GetRequest,159050,878640,1550000,8470000,108140000,119197690
5901,TCP,SSLSessionReq,158900,1500000,1680000,8200000,105590000,117128900
264,TCP,GenericLines,158380,1110000,1570000,8840000,124100000,135778380
1022,TCP,SSLSessionReq,158110,1400000,1450000,7420000,104540000,114968110
5269,TCP,GetRequest,157650,641300,1510000,7700000,107250000,117258950
465,TCP,GetRequest,156700,3460000,3000000,7260000,102820000,116696700
513,TCP,DNSStatusRequest,156520,918450,1450000,7860000,108820000,119204970
1099,TCP,JavaRMI,155320,1570000,3720000,134640000,252920000,393005320
8088,TCP,Socks4,155210,859780,1780000,65020000,113780000,181594990
8194,TCP,SSLSessionReq,155090,1410000,3440000,69750000,225220000,299975090
8005,TCP,GetRequest,153570,1120000,1420000,41950000,98840000,143483570
902,TCP,GetRequest,153460,701760,1480000,7380000,104610000,114325220
7070,TCP,RTSPRequest,151190,3180000,17830000,59710000,106480000,187351190
79,TCP,Help,149630,970560,1320000,7580000,109780000,119800190
7070,TCP,GetRequest,148700,3070000,16320000,17450000,98210000,135198700
513,TCP,DNSVersionBindReq,147890,741100,1370000,7680000,106630000,116568990
113,TCP,Help,147410,580050,1200000,59180000,84890000,145997460
19,TCP,GetRequest,147120,833760,1340000,7510000,109030000,118860880
993,TCP,GetRequest,143840,4370000,3460000,7800000,107240000,123013840
9002,TCP,GenericLines,141660,1190000,1630000,8210000,108390000,119561660
11211,TCP,Memcache,141580,1060000,1900000,70880000,123750000,197731580
280,TCP,GetRequest,141290,737450,1320000,7790000,108690000,118678740
9090,TCP,SqueezeCenter_CLI,141210,757940,1970000,63540000,116520000,182929150
49157,TCP,GetRequest,140040,1080000,3510000,7850000,102590000,115170040
6543,TCP,DNSVersionBindReq,138690,1100000,1490000,7630000,106100000,116458690
3690,TCP,GetRequest,138120,1250000,1570000,7860000,104510000,115328120
3000,TCP,NCP,137310,707340,1910000,62560000,113910000,179224650
10001,TCP,GetRequest,137290,1970000,2270000,12150000,156440000,172967290
8007,TCP,GetRequest,134970,1100000,1440000,41350000,98310000,142334970
6668,TCP,Socks4,132770,1510000,2750000,113600000,203300000,321292770
7777,TCP,Socks5,132280,854140,1670000,66930000,124250000,193836420
5000,TCP,DNSVersionBindReq,131670,782380,2820000,7900000,108930000,120564050
902,TCP,SSLSessionReq,131530,697950,1430000,7260000,103830000,113349480
50003,TCP,ibm-db2,131520,783110,1870000,66450000,125310000,194544630
1031,TCP,SMBProgNeg,131230,672620,1620000,58160000,109060000,169643850
19,TCP,SSLSessionReq,130540,819430,1540000,7470000,109260000,119219970
17,UDP,RPCCheck,129300,0,0,150850000,0,150979300
32768,UDP,RPCCheck,127890,0,0,145620000,0,145747890
83,TCP,GetRequest,126140,597620,1310000,7700000,107110000,116843760
445,TCP,SSLSessionReq,124480,1110000,996740,3840000,101940000,108011220
13,UDP,Help,122200,0,0,153690000,0,153812200
32771,UDP,RPCCheck,121960,0,0,300360000,0,300481960
593,TCP,GetRequest,120720,433050,912910,5250000,101580000,108296680
3690,TCP,SSLSessionReq,118200,2210000,1420000,7870000,104140000,115758200
6667,TCP,Socks4,117600,1070000,1570000,63120000,127110000,192987600
515,TCP,TerminalServer,117010,1750000,4660000,136000000,246030000,388557010
3268,TCP,LDAPBindReq,116970,825010,1620000,58140000,108280000,168981980
995,TCP,GetRequest,114000,4480000,3670000,7880000,108080000,124224000
83,TCP,FourOhFourRequest,113250,563420,1180000,55400000,95600000,152856670
32751,UDP,RPCCheck,112230,0,0,291230000,0,291342230
50000,TCP,ibm-db2-das,112180,921020,2220000,74290000,130490000,208033200
85,TCP,HTTPOptions,111740,455740,1000000,43990000,80920000,126477480
636,TCP,SSLv23SessionReq,111580,1570000,1560000,7720000,107940000,118901580
636,TCP,SSLSessionReq,109880,1380000,1490000,7840000,107720000,118539880
7777,TCP,X11Probe,109750,1740000,3270000,137140000,242720000,384979750
593,TCP,SSLSessionReq,109510,460640,902150,5240000,101300000,108012300
4000,TCP,SSLSessionReq,108200,1260000,1760000,7940000,104180000,115248200
1080,TCP,Socks5,107880,1210000,1920000,66010000,122230000,191477880
83,TCP,HTTPOptions,107410,750680,1540000,7450000,104470000,114318090
32791,UDP,RPCCheck,106170,0,0,298010000,0,298116170
4444,TCP,SSLv23SessionReq,104940,1100000,1160000,21940000,182150000,206454940
6004,TCP,GetRequest,104590,1020000,1410000,7910000,105280000,115724590
3689,TCP,GetRequest,104180,2440000,3460000,16510000,214680000,237194180
2301,TCP,HTTPOptions,103990,719860,1600000,65950000,122350000,190723850
32761,UDP,RPCCheck,103570,0,0,287220000,0,287323570
1000,TCP,GenericLines,103310,839000,1300000,7550000,105940000,115732310
8002,TCP,FourOhFourRequest,103160,1270000,2120000,67260000,120860000,191613160
1080,TCP,GetRequest,102770,1350000,1480000,7560000,107910000,118402770
5001,TCP,WMSRequest,101490,642030,2220000,56250000,105010000,164223520
517,UDP,RPCCheck,98560,0,0,281610000,0,281708560
6000,TCP,X11Probe,98490,802950,1340000,36800000,68940000,107981440
9100,TCP,drda,98190,2740000,4340000,116360000,215080000,338618190
9090,TCP,WMSRequest,96980,1350000,2420000,69220000,123020000,196106980
1521,TCP,oracle-tns,96760,660710,4210000,54810000,101140000,160917470
8084,TCP,FourOhFourRequest,96150,849240,1770000,60320000,116440000,179475390
1494,TCP,GetRequest,95360,1700000,1810000,8390000,104020000,116015360
5555,TCP,SMBProgNeg,94940,1030000,1760000,44980000,104940000,152804940
5555,TCP,DNSVersionBindReq,94720,1200000,1960000,8560000,110400000,122214720
11211,TCP,memcached,94330,557580,1210000,48440000,85260000,135561910
100,TCP,GetRequest,94270,886760,1300000,7350000,102300000,111931030
6000,TCP,HTTPOptions,93000,1210000,1670000,66650000,123020000,192643000
873,TCP,SSLSessionReq,92950,577460,837310,4860000,65740000,72107720
6004,TCP,SSLSessionReq,92940,688360,1460000,8020000,105580000,115841300
37,UDP,Help,91510,0,0,137690000,0,137781510
8084,TCP,GetRequest,91360,1370000,1720000,47170000,107590000,157941360
79,TCP,SSLSessionReq,91150,878930,1090000,6040000,85420000,93520080
6666,TCP,Help,91000,1590000,2770000,63600000,214110000,282161000
1027,TCP,SSLSessionReq,90600,1170000,2320000,7320000,104330000,115230600
3333,TCP,LPDString,89850,1830000,3470000,116010000,221770000,343169850
9090,TCP,informix,88310,737180,2140000,62290000,119470000,184725490
2103,TCP,GetRequest,87850,1420000,2060000,7830000,104810000,116207850
8010,TCP,GetRequest,86930,2340000,1470000,41910000,98210000,144016930
20000,TCP,oracle-tns,86570,935660,1850000,58030000,103730000,164632230
32801,UDP,RPCCheck,86550,0,0,296470000,0,296556550
50000,TCP,drda,85910,1270000,2350000,65800000,120930000,190435910
7000,TCP,DNSVersionBindReq,85560,875020,1800000,7850000,107460000,118070580
7000,TCP,RPCCheck,85490,688790,1760000,66130000,106690000,175354280
7002,TCP,GetRequest,85480,780770,2000000,19480000,96880000,119226250
6666,TCP,Socks5,85260,553460,1190000,50950000,90630000,143408720
10010,TCP,GetRequest,83430,801430,1470000,7880000,103160000,113394860
5001,TCP,SSLSessionReq,83330,416650,889950,3690000,49240000,54319930
55555,TCP,GetRequest,83250,812870,1980000,63510000,122390000,188776120
8194,TCP,SSLv23SessionReq,82970,784080,1520000,8100000,109430000,119917050
9102,TCP,SMBProgNeg,82180,765210,1560000,55080000,104500000,161987390
10001,TCP,SSLSessionReq,81810,1310000,1530000,8050000,102460000,113431810
7000,TCP,X11Probe,81780,669710,1750000,56380000,106340000,165221490
9091,TCP,informix,81700,1380000,2220000,68210000,120530000,192421700
119,TCP,Help,81340,1020000,2530000,63460000,111040000,178131340
1352,TCP,NotesRPC,81210,892330,1850000,66660000,124580000,194063540
8010,TCP,Socks5,80010,2080000,2220000,68990000,122540000,195910010
9091,TCP,drda,79640,870320,2000000,64280000,122900000,190129960
8009,TCP,SSLSessionReq,78520,693470,1700000,65600000,114600000,182671990
6666,TCP,vp3,78360,1610000,2930000,113590000,208300000,326508360
84,TCP,FourOhFourRequest,77990,637500,1480000,62560000,112070000,176825490
84,TCP,GetRequest,76580,731200,1360000,7790000,108160000,118117780
1024,TCP,SSLSessionReq,76140,832840,2380000,7290000,103740000,114318980
5050,TCP,GetRequest,75740,1030000,2280000,7480000,105170000,116035740
5353,UDP,NTPRequest,75730,0,0,138690000,0,138765730
9097,TCP,informix,75370,1600000,3240000,114730000,208760000,328405370
6667,TCP,Socks5,75340,1660000,1350000,47490000,104890000,155465340
4045,UDP,RPCCheck,74990,0,0,151310000,0,151384990
119,TCP,GenericLines,74740,1290000,2740000,7350000,104170000,115624740
38978,UDP,RPCCheck,74090,0,0,260460000,0,260534090
1234,TCP,GetRequest,73640,982750,1840000,8060000,107300000,118256390
177,UDP,xdmcp,73240,0,0,142700000,0,142773240
1080,TCP,GenericLines,73030,1560000,1450000,7740000,106280000,117103030
11211,UDP,memcached,72650,0,0,130980000,0,131052650
1111,TCP,Help,71970,715660,1690000,60520000,114450000,177447630
5801,TCP,GetRequest,71860,809000,1500000,8520000,108140000,119040860
2005,TCP,GetRequest,71760,1460000,1690000,8030000,104630000,115881760
32781,UDP,RPCCheck,71290,0,0,293960000,0,294031290
8003,TCP,FourOhFourRequest,71220,816430,1750000,75660000,122880000,201177650
60023,TCP,ibm-db2,71000,703750,1840000,68430000,122830000,193874750
2103,TCP,SSLSessionReq,70350,1290000,2040000,8070000,104530000,116000350
2107,TCP,GetRequest,70340,1210000,1980000,7960000,104460000,115680340
1494,TCP,SSLSessionReq,70090,1510000,1850000,7570000,103110000,114110090
42,TCP,SMBProgNeg,70020,615840,1440000,7130000,107050000,116305860
32770,UDP,RPCCheck,69770,0,0,146160000,0,146229770
8031,TCP,GetRequest,69570,1860000,1500000,7740000,102220000,113389570
888,TCP,GetRequest,68760,666960,1340000,7600000,106510000,116185720
9003,TCP,GenericLines,68710,984160,1660000,8360000,108790000,119862870
84,TCP,HTTPOptions,68500,794430,1480000,7520000,103720000,113582930
514,TCP,DNSStatusRequest,68480,822650,1690000,71220000,124360000,198161130
5003,TCP,GetRequest,68250,1130000,1480000,7880000,103820000,114378250
1935,TCP,TerminalServer,68210,749090,1610000,53400000,97880000,153707300
407,UDP,RPCCheck,67460,0,0,150200000,0,150267460
32778,UDP,RPCCheck,67390,0,0,148670000,0,148737390
9102,TCP,hp-pjl,67330,885530,1800000,64460000,119950000,187162860
4045,TCP,RPCCheck,66770,745240,2370000,73130000,123380000,199692010
6667,TCP,Help,66730,1670000,1270000,7180000,105230000,115416730
1080,TCP,Socks4,66450,892690,1910000,64300000,122270000,189439140
6664,TCP,Socks5,65920,1960000,3490000,134680000,243920000,384115920
1110,TCP,GetRequest,65480,1620000,1510000,8390000,104360000,115945480
60021,TCP,ibm-db2,64210,1220000,2110000,66760000,121020000,191174210
31337,TCP,GetRequest,63790,1200000,1260000,7960000,102890000,113373790
626,UDP,serialnumberd,63400,0,0,152600000,0,152663400
8004,TCP,FourOhFourRequest,62960,846690,1870000,74710000,124210000,201699650
10001,TCP,ZendJavaBridge,62670,1170000,2070000,71230000,124240000,198772670
8008,TCP,Socks4,62080,746400,4080000,63650000,113950000,182488480
3128,TCP,Socks4,61910,1560000,3980000,105600000,239030000,350231910
9093,TCP,informix,60920,1280000,2290000,67130000,123140000,193900920
79,TCP,GenericLines,60790,496750,656320,3770000,52440000,57423860
1040,TCP,GenericLines,60740,1150000,1660000,7440000,107340000,117650740
6050,TCP,DNSStatusRequest,60630,677660,1310000,7910000,107500000,117458290
523,TCP,ibm-db2,60560,1670000,3000000,137640000,241870000,384240560
9092,TCP,drda,60560,732530,2960000,67700000,124670000,196123090
9100,UDP,NTPRequest,60260,0,0,149100000,0,149160260
6667,TCP,GenericLines,59880,1470000,1180000,7430000,103100000,113239880
8006,TCP,FourOhFourRequest,59760,678090,1790000,65340000,120470000,188337850
9092,TCP,informix,59750,1210000,2060000,65170000,117520000,186019750
8003,TCP,GetRequest,59300,869250,1330000,37660000,96890000,136808550
4444,TCP,GetRequest,59110,783060,551250,3990000,99130000,104513420
2003,TCP,GetRequest,58610,1290000,1510000,8330000,104760000,115948610
32793,UDP,RPCCheck,58410,0,0,153970000,0,154028410
4444,TCP,SSLSessionReq,58200,549590,571460,4540000,98530000,104249250
2638,UDP,sybaseanywhere,58110,0,0,143740000,0,143798110
8883,TCP,FourOhFourRequest,58060,1960000,3850000,141420000,244120000,391408060
5061,TCP,SIPOptions,57590,949140,1810000,58230000,110370000,171416730
808,TCP,GetRequest,57360,850930,1250000,7390000,102880000,112428290
32768,TCP,RPCCheck,57220,1220000,1510000,7660000,103240000,113687220
3483,UDP,SqueezeCenter,57090,0,0,158260000,0,158317090
32772,UDP,RPCCheck,56740,0,0,149660000,0,149716740
8002,TCP,SSLSessionReq,56200,2080000,1570000,8410000,102220000,114336200
6666,TCP,Socks4,56130,778100,1600000,71620000,127800000,201854230
32769,UDP,RPCCheck,55830,0,0,136880000,0,136935830
32800,UDP,RPCCheck,55740,0,0,141280000,0,141335740
787,TCP,GetRequest,55290,689850,1290000,7370000,102850000,112255140
8009,TCP,FourOhFourRequest,55170,575090,1320000,52180000,87680000,141810260
9093,TCP,drda,55130,616420,1780000,60500000,111010000,173961550
2967,UDP,DNSVersionBindReq,55050,0,0,154350000,0,154405050
32774,UDP,RPCCheck,54870,0,0,167500000,0,167554870
32797,UDP,RPCCheck,54560,0,0,150120000,0,150174560
2005,TCP,SSLSessionReq,54530,1330000,1540000,7710000,104860000,115494530
5120,TCP,GetRequest,54360,982450,1450000,7710000,104580000,114776810
8009,TCP,GetRequest,54090,923090,1320000,32080000,93730000,128107180
32777,UDP,RPCCheck,53690,0,0,154280000,0,154333690
2161,TCP,GetRequest,53370,1210000,1580000,8040000,105520000,116403370
49156,UDP,vuze-dht,53270,0,0,153200000,0,153253270
9101,TCP,hp-pjl,52810,736940,1670000,59480000,111420000,173359750
3351,TCP,pervasive-btrieve,52560,2010000,3940000,132770000,240370000,379142560
32789,UDP,RPCCheck,51770,0,0,144150000,0,144201770
7777,TCP,Arucer,51080,1350000,2000000,69940000,125190000,198531080
2107,TCP,SSLSessionReq,50940,1270000,2120000,7750000,103620000,114810940
32809,UDP,RPCCheck,50620,0,0,153050000,0,153100620
8004,TCP,GetRequest,50420,1050000,1360000,39910000,97200000,139570420
8006,TCP,GetRequest,50130,848260,1360000,38880000,97950000,139088390
444,TCP,GetRequest,49720,260340,497400,2440000,35000000,38247460
32779,UDP,RPCCheck,49680,0,0,138790000,0,138839680
6005,TCP,X11Probe,49640,828330,1390000,47850000,107270000,157387970
6669,TCP,Socks5,49520,943740,1540000,63240000,121910000,187683260
32808,UDP,RPCCheck,49480,0,0,145250000,0,145299480
49153,UDP,vuze-dht,49360,0,0,151420000,0,151469360
49157,TCP,SSLSessionReq,49250,989800,3670000,7910000,103540000,116159050
5003,TCP,SSLSessionReq,49180,1200000,1500000,8090000,104880000,115719180
4443,TCP,GetRequest,49010,1630000,1260000,46410000,87340000,136689010
311,TCP,SSLSessionReq,48900,675660,1260000,7230000,101240000,110454560
1030,TCP,GetRequest,48900,1070000,2180000,7880000,104190000,115368900
31337,TCP,SIPOptions,48880,760940,1470000,59390000,116570000,178239820
1027,TCP,GetRequest,48780,362720,1080000,3530000,47920000,52941500
135,UDP,DNSStatusRequest,48680,0,0,80240000,0,80288680
32806,UDP,RPCCheck,48680,0,0,153980000,0,154028680
9100,TCP,informix,48630,1320000,2730000,62150000,119150000,185398630
518,UDP,RPCCheck,48610,0,0,143580000,0,143628610
49154,UDP,vuze-dht,48470,0,0,153530000,0,153578470
3372,TCP,GetRequest,48410,946250,1720000,8000000,108660000,119374660
32750,UDP,RPCCheck,48240,0,0,145520000,0,145568240
32780,UDP,RPCCheck,48110,0,0,142350000,0,142398110
32760,UDP,RPCCheck,47860,0,0,146500000,0,146547860
12203,UDP,RPCCheck,47840,0,0,142060000,0,142107840
179,TCP,SSLSessionReq,47640,1390000,1260000,6860000,101410000,110967640
6112,TCP,GenericLines,47560,1030000,1380000,7940000,105520000,115917560
32758,UDP,RPCCheck,47560,0,0,186860000,0,186907560
3001,TCP,NCP,47380,663530,2210000,62470000,115790000,181180910
1419,UDP,RPCCheck,47260,0,0,143520000,0,143567260
32805,UDP,RPCCheck,47150,0,0,144530000,0,144577150
1110,TCP,SSLSessionReq,47130,1490000,1640000,8400000,104070000,115647130
514,TCP,DNSVersionBindReq,46970,1240000,1820000,64320000,116150000,183576970
32803,UDP,RPCCheck,46910,0,0,143550000,0,143596910
32776,UDP,RPCCheck,46700,0,0,128570000,0,128616700
17988,TCP,GetRequest,46610,714000,1670000,61890000,119300000,183620610
2105,TCP,DNSVersionBindReq,46590,1080000,1930000,56420000,101260000,160736590
900,TCP,GetRequest,46460,860640,1350000,7820000,107830000,117907100
5050,TCP,SSLSessionReq,46410,845540,2370000,7450000,104840000,115551950
254,TCP,GetRequest,46300,889850,1220000,6850000,101780000,110786150
32787,UDP,RPCCheck,45920,0,0,143340000,0,143385920
100,TCP,SSLSessionReq,45840,680070,1410000,7260000,100850000,110245910
179,TCP,GetRequest,45770,1280000,1220000,6760000,98790000,108095770
32782,UDP,RPCCheck,45720,0,0,151350000,0,151395720
6014,TCP,X11Probe,45590,1280000,2950000,124930000,229790000,358995590
32794,UDP,RPCCheck,45410,0,0,153540000,0,153585410
1505,UDP,pc-duo,45210,0,0,122450000,0,122495210
32792,UDP,RPCCheck,45170,0,0,151070000,0,151115170
32785,UDP,RPCCheck,45030,0,0,146750000,0,146795030
3333,TCP,GenericLines,44830,1180000,1570000,7340000,105080000,115214830
32765,UDP,RPCCheck,44790,0,0,150280000,0,150324790
1029,TCP,GetRequest,44750,1920000,2150000,8060000,103760000,115934750
9097,TCP,drda,44630,820130,1910000,71580000,126510000,200864760
32790,UDP,RPCCheck,44500,0,0,143110000,0,143154500
5666,TCP,SSLSessionReq,44380,1960000,1520000,7830000,105130000,116484380
32798,UDP,RPCCheck,44160,0,0,143340000,0,143384160
32807,UDP,RPCCheck,43920,0,0,147960000,0,148003920
32775,UDP,RPCCheck,43870,0,0,152530000,0,152573870
32767,UDP,RPCCheck,43580,0,0,150800000,0,150843580
32795,UDP,RPCCheck,43560,0,0,150480000,0,150523560
9050,TCP,GetRequest,43510,807090,1700000,61490000,119910000,183950600
32786,UDP,RPCCheck,43420,0,0,143360000,0,143403420
32773,UDP,RPCCheck,43230,0,0,148640000,0,148683230
32753,UDP,RPCCheck,43180,0,0,136410000,0,136453180
10080,UDP,RPCCheck,43080,0,0,134680000,0,134723080
4711,TCP,GetRequest,43020,834990,1580000,8340000,108530000,119328010
6668,TCP,Socks5,42910,713280,1450000,62310000,118140000,182656190
3002,TCP,GetRequest,42510,712850,1580000,7930000,107230000,117495360
1028,TCP,GetRequest,42190,874110,2310000,7850000,103840000,114916300
32757,UDP,RPCCheck,42140,0,0,142750000,0,142792140
15000,TCP,GetRequest,41980,1460000,1330000,7190000,101590000,111611980
6346,TCP,GetRequest,41090,717200,1300000,8070000,110530000,120658290
3128,TCP,GenericLines,40910,389380,1140000,3240000,54530000,59340290
27001,TCP,SMBProgNeg,40910,2090000,3740000,78330000,230100000,314300910
1604,UDP,Citrix,40790,0,0,145880000,0,145920790
32754,UDP,RPCCheck,40780,0,0,145470000,0,145510780
27000,TCP,SMBProgNeg,40730,911740,1720000,28680000,97270000,128622470
12345,TCP,Help,40650,1320000,1550000,7820000,108750000,119480650
2161,TCP,SSLSessionReq,40120,1320000,1600000,8190000,105140000,116290120
8009,TCP,SSLv23SessionReq,39630,1060000,1930000,42330000,99280000,144639630
49155,UDP,vuze-dht,39560,0,0,143200000,0,143239560
1031,TCP,GetRequest,39400,661450,1530000,7850000,102730000,112810850
32768,TCP,GetRequest,39130,1080000,1480000,7630000,100460000,110689130
787,TCP,SSLSessionReq,38820,653280,1280000,7420000,102730000,112122100
2160,TCP,GetRequest,38810,1530000,1710000,7970000,107770000,119018810
2003,TCP,SSLSessionReq,38590,1630000,1760000,8000000,104610000,116038590
32788,UDP,RPCCheck,38560,0,0,151270000,0,151308560
13722,TCP,GetRequest,38520,658960,1500000,57480000,109880000,169557480
5550,TCP,SSLv23SessionReq,38240,1180000,1480000,8310000,109310000,120318240
3372,TCP,RTSPRequest,38170,1430000,1690000,7980000,103280000,114418170
6379,TCP,redis-server,38020,720730,1780000,66510000,121790000,190838750
1214,TCP,GetRequest,37640,824150,1290000,7820000,108560000,118531790
32783,UDP,RPCCheck,37280,0,0,154380000,0,154417280
2303,UDP,pc-duo-gw,37090,0,0,129290000,0,129327090
6660,TCP,Socks4,37000,659890,1540000,69070000,122530000,193836890
32766,UDP,RPCCheck,36920,0,0,128790000,0,128826920
32802,UDP,RPCCheck,36910,0,0,155500000,0,155536910
5550,TCP,SSLSessionReq,36760,1130000,1620000,8190000,108730000,119706760
6669,TCP,Socks4,36750,866640,1470000,57120000,121120000,180613390
8887,TCP,GetRequest,36680,1050000,1440000,7490000,103760000,113776680
32763,UDP,RPCCheck,36680,0,0,147810000,0,147846680
9801,TCP,GenericLines,36420,1440000,1630000,8770000,111050000,122926420
523,UDP,ibm-db2-das-udp,36260,0,0,145820000,0,145856260
6665,TCP,Socks5,36110,662920,1630000,67290000,123160000,192779030
5802,TCP,GetRequest,35930,941900,1450000,8320000,108550000,119297830
32755,UDP,RPCCheck,35840,0,0,147080000,0,147115840
2383,TCP,GetRequest,35710,1300000,1580000,8090000,106400000,117405710
646,TCP,GetRequest,35600,790610,1200000,6800000,102330000,111156210
9030,TCP,GetRequest,35500,1210000,1490000,51160000,107520000,161415500
32770,TCP,RPCCheck,35470,1170000,2200000,8170000,105100000,116675470
60000,TCP,drda,35430,1210000,2410000,70620000,124590000,198865430
32759,UDP,RPCCheck,35330,0,0,135100000,0,135135330
32771,TCP,RPCCheck,35240,1790000,2320000,7810000,106040000,117995240
990,TCP,GetRequest,35230,632990,991970,4480000,62110000,68250190
32804,UDP,RPCCheck,35210,0,0,155740000,0,155775210
49152,UDP,vuze-dht,35110,0,0,137460000,0,137495110
3703,TCP,GetRequest,35090,1130000,1420000,7880000,104340000,114805090
42,UDP,Help,35080,0,0,145580000,0,145615080
27017,TCP,mongodb,35070,547010,1500000,53980000,98900000,154962080
1761,UDP,DNSStatusRequest,34980,0,0,135980000,0,136014980
32796,UDP,RPCCheck,34890,0,0,138510000,0,138544890
32810,UDP,RPCCheck,34860,0,0,130520000,0,130554860
9096,TCP,drda,34530,1180000,2000000,65050000,117160000,185424530
6699,TCP,GetRequest,34400,1180000,1320000,7860000,108600000,118994400
5280,TCP,GetRequest,34360,1030000,1490000,8270000,109150000,119974360
9096,TCP,informix,34360,1260000,2150000,66860000,121390000,191694360
2701,TCP,LANDesk-RC,34340,723760,2310000,66220000,122990000,192278100
1035,TCP,GetRequest,34270,1170000,1510000,7920000,104230000,114864270
7100,TCP,GetRequest,34240,741800,1400000,28590000,92870000,123636040
17555,UDP,vuze-dht,34210,0,0,132030000,0,132064210
1344,TCP,GetRequest,34160,1240000,1750000,8070000,108130000,119224160
32784,UDP,RPCCheck,34050,0,0,147530000,0,147564050
2396,TCP,GetRequest,33930,1210000,1570000,8170000,109240000,120223930
2010,TCP,GenericLines,33780,1250000,1530000,7800000,105430000,116043780
5631,TCP,GetRequest,33750,2110000,1420000,7580000,100840000,111983750
3052,TCP,GetRequest,33380,960320,1510000,7820000,108370000,118693700
7100,TCP,X11Probe,33300,731100,1990000,67160000,117100000,187014400
32799,UDP,RPCCheck,33280,0,0,138480000,0,138513280
8118,TCP,GetRequest,33250,821650,1420000,7610000,103230000,113114900
1981,TCP,JavaRMI,33170,523880,1340000,47360000,89750000,139007050
901,TCP,GetRequest,33070,609740,1320000,7170000,106140000,115272810
2401,TCP,Help,33010,581290,1540000,7930000,107130000,117214300
27960,UDP,RPCCheck,32980,0,0,139500000,0,139532980
8887,TCP,FourOhFourRequest,32930,760300,1890000,63630000,124150000,190463230
5101,TCP,GetRequest,32860,1220000,1550000,7580000,104850000,115232860
10005,TCP,GetRequest,32810,642630,1310000,50640000,96220000,148845440
111,TCP,GetRequest,32730,1250000,2050000,6870000,102260000,112462730
1720,TCP,TerminalServer,32710,645730,4800000,45120000,85940000,136538440
1583,TCP,pervasive-relational,32630,693230,1840000,64970000,123810000,191345860
2064,TCP,GetRequest,32550,1070000,1590000,8260000,108500000,119452550
6662,TCP,Socks5,32550,945490,1550000,67110000,119060000,188698040
10031,TCP,HTTPOptions,32550,764320,1720000,67770000,122700000,192986870
32756,UDP,RPCCheck,32410,0,0,122090000,0,122122410
7402,TCP,GetRequest,32370,1080000,1490000,7400000,100810000,110812370
1033,TCP,GetRequest,32360,1410000,1550000,7930000,103520000,114442360
5432,TCP,GetRequest,32340,735000,1490000,8000000,107640000,117897340
2717,TCP,GetRequest,32310,1240000,1500000,7880000,105990000,116642310
6600,TCP,GetRequest,32240,1280000,1420000,8120000,108600000,119452240
8881,TCP,GetRequest,32190,672370,1660000,43580000,100780000,146724560
1056,TCP,GetRequest,32160,1220000,1480000,7620000,102740000,113092160
60009,TCP,ibm-db2,32130,1360000,3070000,117790000,211770000,334022130
6663,TCP,Socks5,32000,1230000,1960000,66520000,123810000,193552000
6668,TCP,Help,32000,674400,1600000,64150000,121910000,188366400
523,TCP,ibm-db2-das,31970,662310,1410000,65020000,116870000,183994280
514,TCP,RPCCheck,31930,795120,1350000,7330000,104460000,113967050
1066,TCP,GetRequest,31840,1290000,1510000,7950000,103600000,114381840
1064,TCP,GetRequest,31650,929760,1600000,8020000,102600000,113181410
6660,TCP,Socks5,31630,658910,1470000,63440000,114740000,180340540
32777,TCP,RPCCheck,31570,1800000,3540000,62880000,211930000,280181570
14534,TCP,GetRequest,31500,733960,1650000,59250000,117210000,178875460
32772,TCP,RPCCheck,31490,857810,2050000,65720000,124710000,193369300
8886,TCP,GetRequest,31390,1520000,1550000,7250000,102660000,113011390
1054,TCP,GetRequest,31250,1290000,1630000,7500000,102490000,112941250
1037,TCP,GetRequest,31100,1910000,1510000,8100000,102930000,114481100
1036,TCP,GetRequest,31070,1460000,1570000,7900000,103030000,113991070
445,TCP,GetRequest,31010,1150000,1250000,3700000,102140000,108271010
1074,TCP,GetRequest,30970,1200000,1520000,8450000,104360000,115560970
6003,TCP,X11Probe,30930,569430,1330000,55430000,104070000,161430360
1071,TCP,GetRequest,30620,1150000,1760000,7770000,103630000,114340620
6103,TCP,GetRequest,30580,1130000,1590000,9500000,108240000,120490580
1039,TCP,GetRequest,30510,1160000,1450000,7700000,103910000,114250510
808,TCP,SSLSessionReq,30480,941320,1720000,7370000,103050000,113111800
1065,TCP,GetRequest,30330,840280,1550000,7840000,102580000,112840610
1801,TCP,GetRequest,30310,1260000,1570000,8360000,104100000,115320310
3986,TCP,GetRequest,30280,1180000,1600000,7750000,105690000,116250280
32764,UDP,RPCCheck,30230,0,0,153880000,0,153910230
88,UDP,RPCCheck,30170,0,0,115440000,0,115470170
1095,TCP,Socks5,30170,1560000,3510000,138630000,250940000,394670170
2306,TCP,GetRequest,29990,1220000,1560000,8070000,108860000,119739990
70,TCP,GetRequest,29880,679390,1390000,7750000,110150000,119999270
1044,TCP,GetRequest,29860,1270000,1440000,7730000,103510000,113979860
1058,TCP,GetRequest,29760,1390000,1630000,7580000,102260000,112889760
1059,TCP,GetRequest,29660,1310000,1430000,7710000,102490000,112969660
1048,TCP,GetRequest,29650,1260000,1450000,7540000,103310000,113589650
254,TCP,SSLSessionReq,29520,695350,1500000,6940000,101850000,111014870
3031,TCP,NCP,29370,696650,1700000,63280000,116590000,182296020
1049,TCP,GetRequest,29330,2150000,1480000,7760000,102860000,114279330
60000,TCP,ibm-db2,29280,796320,1780000,58810000,105420000,166835600
3689,TCP,SSLSessionReq,29240,1610000,1700000,8100000,106330000,117769240
1069,TCP,GetRequest,29230,976640,1500000,7590000,102970000,113065870
8884,TCP,GetRequest,29230,843310,1910000,59680000,120840000,183302540
1053,TCP,GetRequest,29170,1470000,1440000,7580000,102500000,113019170
8882,TCP,GetRequest,29140,1260000,1670000,56220000,114930000,174109140
9099,TCP,informix,29130,752260,1950000,65250000,124080000,192061390
32762,UDP,RPCCheck,29090,0,0,148570000,0,148599090
1998,TCP,GetRequest,29080,1470000,1500000,8180000,105270000,116449080
1220,TCP,GetRequest,29000,1370000,1590000,7840000,106420000,117249000
6011,TCP,X11Probe,28900,690140,1460000,71120000,118790000,192089040
2040,TCP,TerminalServer,28710,1230000,2210000,70530000,124740000,198738710
8881,TCP,FourOhFourRequest,28610,582720,1640000,52310000,98770000,153331330
5051,TCP,GetRequest,28340,1520000,1220000,7030000,86230000,96028340
144,TCP,GetRequest,28320,746070,1260000,7160000,102190000,111384390
32764,TCP,RPCCheck,28300,756300,1790000,64240000,123780000,190594600
1100,TCP,Socks5,28280,705600,1870000,65420000,124900000,192923880
6010,TCP,X11Probe,28270,466060,1200000,50460000,92680000,144834330
50030,TCP,GetRequest,28260,513160,960360,8810000,114760000,125071780
1754,TCP,oracle-tns,28120,1400000,3600000,130970000,244480000,380478120
7144,TCP,GenericLines,28090,1060000,1590000,8060000,107760000,118498090
5666,TCP,GetRequest,27930,2240000,1610000,7870000,105410000,117157930
6668,TCP,GenericLines,27840,1780000,1420000,7950000,103960000,115137840
1,TCP,GetRequest,27750,797740,1410000,7840000,110250000,120325490
9099,TCP,drda,27420,1290000,2160000,69720000,123380000,196577420
32752,UDP,RPCCheck,27420,0,0,147100000,0,147127420
8885,TCP,FourOhFourRequest,27330,1220000,2160000,68920000,123800000,196127330
32769,TCP,RPCCheck,27310,743030,1880000,64150000,123690000,190490340
5803,TCP,GetRequest,27280,740320,1570000,8260000,108640000,119237600
9103,TCP,SMBProgNeg,27070,745700,1710000,67290000,122080000,191852770
8886,TCP,FourOhFourRequest,26950,755240,1740000,62800000,123210000,188532190
6669,TCP,Help,26920,891620,1250000,7540000,106880000,116588540
6006,TCP,X11Probe,26880,627640,1480000,65660000,119260000,187054520
8883,TCP,GetRequest,26880,1360000,1540000,52350000,109580000,164856880
9095,TCP,drda,26880,1060000,2020000,71620000,125460000,200186880
9103,TCP,hp-pjl,26540,1130000,2010000,62900000,112430000,178496540
5232,TCP,HTTPOptions,26500,1330000,1540000,7580000,103170000,113646500
8885,TCP,GetRequest,26470,1220000,1710000,58140000,117700000,178796470
9,TCP,GetRequest,26460,708730,1530000,7540000,108780000,118585190
6662,TCP,Socks4,26460,787800,1290000,58960000,105740000,166804260
2715,TCP,GetRequest,26390,1040000,1660000,7950000,108710000,119386390
311,TCP,GetRequest,26340,798640,1510000,7180000,101450000,110964980
1029,TCP,SSLSessionReq,26100,996220,2520000,7950000,103770000,115262320
6017,TCP,X11Probe,25980,631270,1420000,64610000,116610000,183297250
13666,TCP,GetRequest,25890,794060,1710000,66640000,125620000,194789950
2967,TCP,DNSVersionBindReq,25840,1080000,1590000,8010000,111290000,121995840
50025,TCP,ibm-db2,25800,1480000,3450000,135850000,238850000,379655800
15002,TCP,GenericLines,25790,1170000,1960000,8370000,109910000,121435790
898,TCP,GetRequest,25750,652580,1310000,7820000,106790000,116598330
6544,TCP,GetRequest,25750,806980,1550000,8540000,106990000,117912730
1098,TCP,JavaRMI,25630,605910,1520000,56430000,103010000,161591540
7007,TCP,GetRequest,25570,1040000,1970000,17920000,98070000,119025570
1042,TCP,GetRequest,25510,634680,1610000,8010000,108300000,118580190
3002,TCP,NCP,25150,717630,1920000,68430000,126910000,198002780
4660,TCP,GetRequest,25130,988430,1460000,7790000,107470000,117733560
6007,TCP,X11Probe,25120,704290,1450000,62220000,115010000,179409410
6588,TCP,Socks5,25020,1210000,2000000,65410000,118560000,187205020
641,TCP,HTTPOptions,24970,845790,1580000,66110000,122960000,191520760
9107,TCP,hp-pjl,24970,1200000,2200000,69580000,124320000,197324970
6015,TCP,X11Probe,24960,718770,1650000,65720000,122050000,190163730
6646,TCP,GetRequest,24940,1250000,1360000,8060000,102980000,113674940
6009,TCP,X11Probe,24840,749750,1380000,61570000,111710000,175434590
50001,TCP,ibm-db2,24720,1310000,1830000,55380000,103400000,161944720
8884,TCP,FourOhFourRequest,24620,682610,1550000,64080000,112390000,178727230
497,TCP,X11Probe,24610,668420,1450000,66060000,123160000,191363030
544,TCP,GetRequest,24600,702710,1390000,7330000,102980000,112427310
1248,TCP,GenericLines,24540,1370000,1510000,7550000,104730000,115184540
1314,TCP,GetRequest,24530,1000000,1520000,7990000,107040000,117574530
3,TCP,GetRequest,24440,810690,1700000,7750000,112930000,123215130
13013,TCP,GetRequest,24350,765650,1530000,57400000,113050000,172770000
6016,TCP,X11Probe,24270,718140,1590000,67710000,122540000,192582410
32767,TCP,RPCCheck,24270,1880000,3320000,70630000,228200000,304054270
6802,TCP,NCP,24160,1580000,3970000,143020000,255480000,404074160
6012,TCP,X11Probe,24150,670290,1480000,70230000,120660000,193064440
6669,TCP,GenericLines,24070,827300,1220000,7850000,105690000,115611370
1610,TCP,GetRequest,23900,783870,1710000,7830000,107700000,118047770
3872,TCP,GetRequest,23820,646940,1530000,7950000,109060000,119210760
1830,TCP,GetRequest,23750,1220000,1660000,7940000,107870000,118713750
514,TCP,GetRequest,23680,857880,1340000,7740000,107350000,117311560
1755,TCP,WMSRequest,23630,1650000,3790000,133280000,243360000,382103630
11371,TCP,GetRequest,23600,664580,1580000,57720000,113510000,173498180
5427,TCP,GetRequest,23540,901770,1490000,7780000,108800000,118995310
625,TCP,GetRequest,23500,643890,1290000,7150000,102620000,111727390
1503,TCP,GetRequest,23420,803520,1620000,8130000,107730000,118306940
3280,TCP,GetRequest,23220,1270000,1640000,8000000,106970000,117903220
1611,TCP,GetRequest,23190,1030000,1540000,7930000,107130000,117653190
32775,TCP,RPCCheck,22860,702580,2040000,66520000,124450000,193735440
3531,TCP,GetRequest,22710,1130000,1370000,7470000,101590000,111582710
8770,TCP,apple-iphoto,22670,688050,1590000,61980000,109450000,173730720
540,TCP,GetRequest,22650,700680,1300000,7650000,106460000,116133330
1217,TCP,NCP,22460,1440000,4590000,128260000,239240000,373552460
6008,TCP,X11Probe,22310,625580,1390000,59430000,101460000,162927890
7776,TCP,GetRequest,22300,1000000,1930000,14820000,101400000,119172300
9098,TCP,informix,22210,733850,1860000,63790000,123020000,189426060
1500,TCP,Verifier,22200,1230000,2110000,65350000,120320000,189032200
8882,TCP,FourOhFourRequest,22090,588440,1370000,50800000,96020000,148800530
3310,TCP,GenericLines,22050,1060000,2350000,7990000,105770000,117192050
5530,TCP,DNSVersionBindReq,21980,1910000,3720000,133960000,238610000,378221980
40193,TCP,GetRequest,21750,719290,1570000,60970000,113900000,177181040
1526,TCP,informix,21660,2620000,3550000,123890000,224260000,354341660
7180,TCP,GetRequest,21650,582900,1170000,10180000,132420000,144374550
15000,TCP,GenericLines,21610,1040000,1540000,8310000,108410000,119321610
50022,TCP,ibm-db2,21610,726310,1880000,66430000,124150000,193207920
60001,TCP,ibm-db2,21550,681940,1390000,48170000,91880000,142143490
1028,TCP,SSLSessionReq,21520,1090000,2250000,8120000,104180000,115661520
2024,TCP,GenericLines,21340,861650,1470000,7780000,106370000,116502990
1090,TCP,Socks5,21320,829380,1790000,68500000,123470000,194610700
9089,TCP,informix,21270,1310000,2120000,70680000,124790000,198921270
32774,TCP,RPCCheck,21170,838020,2130000,63100000,122940000,189029190
5520,TCP,DNSVersionBindReq,21040,886280,1610000,54140000,99540000,156197320
1030,TCP,SSLSessionReq,21020,810980,1770000,5460000,76860000,84922000
3052,TCP,RTSPRequest,20730,742850,1270000,51100000,88820000,141953580
10010,TCP,SSLSessionReq,20700,830090,1490000,7920000,104500000,114760790
1029,TCP,DNSVersionBindReq,20560,754490,2250000,62990000,113770000,179785050
1031,TCP,SSLSessionReq,20480,1640000,1660000,8080000,102480000,113880480
9088,TCP,informix,20460,736510,1850000,65310000,122790000,190706970
5432,TCP,GenericLines,20390,1270000,1490000,8040000,106030000,116850390
9105,TCP,hp-pjl,20340,1240000,2100000,66570000,121370000,191300340
7937,TCP,GetRequest,20300,1030000,1480000,7880000,103770000,114180300
2068,TCP,DNSVersionBindReq,20180,956100,1490000,7700000,107400000,117566280
6661,TCP,Socks5,20100,1150000,1930000,68810000,122150000,194060100
32773,TCP,RPCCheck,20090,829400,2450000,62690000,122110000,188099490
5120,TCP,SSLSessionReq,20080,1040000,1460000,6800000,91310000,100630080
1200,TCP,NCP,20000,713760,1880000,69240000,126870000,198723760
9094,TCP,drda,20000,1100000,1970000,68060000,119480000,190630000
8307,TCP,RPCCheck,19960,1860000,3250000,83050000,229670000,317849960
9106,TCP,hp-pjl,19930,713170,1700000,63990000,119380000,185803100
6018,TCP,X11Probe,19920,639040,1380000,64560000,113100000,179698960
50005,TCP,ibm-db2,19770,1180000,2810000,113530000,201900000,319439770
9089,TCP,drda,19620,1270000,1980000,63810000,117040000,184119620
1050,TCP,SSLSessionReq,19590,1240000,2120000,7840000,103080000,114299590
1761,TCP,LANDesk-RC,19350,1240000,2220000,70580000,124130000,198189350
1038,TCP,GetRequest,19270,455490,843380,4310000,57380000,63008140
6664,TCP,Socks4,19270,1150000,1970000,68480000,122950000,194569270
7938,TCP,GetRequest,19160,1040000,1350000,7950000,98420000,108779160
6020,TCP,X11Probe,19120,573760,1480000,62600000,113140000,177812880
6013,TCP,X11Probe,19100,499540,1190000,50550000,94060000,146318640
5556,TCP,DNSVersionBindReq,18920,791110,1740000,71020000,121560000,195130030
9104,TCP,hp-pjl,18880,832050,1840000,68130000,124900000,195720930
591,TCP,GetRequest,18660,692630,1350000,7780000,107080000,116921290
1100,TCP,Socks4,18590,1050000,1730000,56100000,102430000,161328590
2383,TCP,SSLSessionReq,18400,1700000,1610000,8140000,105960000,117428400
6661,TCP,Socks4,18390,677390,1470000,66610000,123600000,192375780
32757,TCP,RPCCheck,18350,2550000,3210000,70880000,224980000,301638350
9094,TCP,informix,18300,583940,1530000,57490000,104410000,164032240
9095,TCP,informix,18280,859450,1540000,52380000,95390000,150187730
60022,TCP,ibm-db2,18200,638710,1480000,55930000,105250000,163316910
1501,TCP,VerifierAdvanced,17970,680270,1720000,68030000,122200000,192648240
1035,TCP,SSLSessionReq,17700,1360000,1780000,8000000,103660000,114817700
32771,TCP,GetRequest,17690,964210,1930000,7790000,102640000,113341900
22001,TCP,NotesRPC,17590,1120000,2010000,71730000,125180000,200057590
783,TCP,GetRequest,17480,654970,1330000,7710000,108140000,117852450
3004,TCP,NCP,17480,1240000,2190000,68790000,123100000,195337480
9088,TCP,drda,17330,842590,1600000,57610000,103360000,163429920
497,TCP,GetRequest,17240,797740,1320000,7690000,107770000,117594980
505,TCP,GetRequest,17010,568740,1350000,7710000,107070000,116715750
5570,TCP,GenericLines,16940,1120000,1570000,8090000,106770000,117566940
32776,TCP,RPCCheck,16860,620380,1880000,55060000,108120000,165697240
771,TCP,GenericLines,16800,1020000,1350000,7550000,106020000,115956800
6670,TCP,Help,16770,1260000,1270000,7980000,107060000,117586770
5631,TCP,SSLSessionReq,16730,2200000,1590000,8040000,105100000,116946730
6163,TCP,HELP4STOMP,16680,779680,1980000,70400000,123770000,196946360
3006,TCP,SMBProgNeg,16540,774550,1780000,29920000,100380000,132871090
6019,TCP,X11Probe,16500,788110,1180000,55820000,97450000,155254610
6588,TCP,Socks4,16500,681570,1820000,67410000,124860000,194788070
18086,TCP,GenericLines,16470,1280000,1670000,8440000,110040000,121446470
60002,TCP,ibm-db2,16470,797960,1760000,74720000,122250000,199544430
6663,TCP,Socks4,16230,761740,1380000,62090000,111000000,175247970
1112,TCP,SMBProgNeg,16190,656340,1550000,56720000,109800000,168742530
50002,TCP,ibm-db2,16190,750080,1930000,64300000,123390000,190386270
620,TCP,GetRequest,16130,575990,1470000,7690000,107800000,117552120
1056,TCP,SSLSessionReq,16090,1260000,1490000,7720000,103110000,113596090
1032,TCP,SSLSessionReq,16000,1020000,1580000,7920000,103020000,113556000
8087,TCP,riak-pbc,15920,873050,1430000,51700000,91840000,145858970
1414,TCP,ibm-mqseries,15830,848530,2920000,67100000,123370000,194254360
1035,TCP,oracle-tns,15800,709170,1810000,63130000,119420000,185084970
3006,TCP,NCP,15780,775770,1780000,69960000,125710000,198241550
406,TCP,SIPOptions,15710,1800000,3410000,139250000,250040000,394515710
1417,TCP,ibm-mqseries,15680,1070000,1960000,70400000,123400000,196845680
15001,TCP,GenericLines,15640,1160000,1740000,8440000,109260000,120615640
449,TCP,GenericLines,15600,719500,1280000,7510000,105420000,114945100
646,TCP,SSLSessionReq,15450,706650,1360000,6770000,102530000,111382100
256,TCP,LDAPBindReq,15390,710940,1700000,64250000,124660000,191336330
2627,TCP,Help,15300,715320,1580000,60260000,111600000,174170620
512,TCP,DNSVersionBindReq,15290,902100,1320000,7650000,105990000,115877390
7008,TCP,DNSVersionBindReq,15280,1190000,2200000,68050000,122480000,193935280
1748,TCP,oracle-tns,15210,860140,1790000,69480000,125860000,198005350
3005,TCP,NCP,15180,718190,2110000,69060000,126750000,198653370
7145,TCP,GenericLines,15180,1300000,1650000,8430000,109940000,121335180
49400,TCP,HTTPOptions,15170,528550,1200000,50980000,88240000,140963720
1038,TCP,SSLSessionReq,15150,843680,1490000,8080000,103260000,113688830
2717,TCP,SSLSessionReq,15140,1610000,1560000,8040000,104800000,116025140
1241,TCP,SSLv23SessionReq,15050,660410,1650000,59690000,114590000,176605460
544,TCP,DNSVersionBindReq,15010,1810000,2970000,120890000,214820000,340505010
1033,TCP,SSLSessionReq,14890,1550000,1560000,7870000,103640000,114634890
5051,TCP,SSLSessionReq,14870,1520000,1510000,7920000,104710000,115674870
7780,TCP,GenericLines,14870,1030000,1570000,8310000,107790000,118714870
1109,TCP,Socks5,14830,673240,1640000,63760000,116750000,182838070
6560,TCP,Help,14820,613420,1430000,7770000,106950000,116778240
1054,TCP,SSLSessionReq,14780,1360000,1600000,7470000,102370000,112814780
1028,TCP,TerminalServer,14770,589240,2070000,48600000,95030000,146304010
1048,TCP,SSLSessionReq,14760,1330000,1500000,7830000,103650000,114324760
4155,TCP,GenericLines,14740,1050000,1650000,7700000,107080000,117494740
5101,TCP,SSLSessionReq,14680,1370000,1580000,7630000,105000000,115594680
4999,TCP,RPCCheck,14630,824580,1750000,74010000,122210000,198809210
7210,TCP,SSLv23SessionReq,14550,701870,1830000,67170000,122720000,192436420
1037,TCP,SSLSessionReq,14540,1370000,1560000,8120000,103410000,114474540
2600,TCP,GenericLines,14510,934100,1470000,7970000,105600000,115988610
6670,TCP,GenericLines,14510,1220000,1330000,8190000,106470000,117224510
9098,TCP,drda,14500,532790,1260000,50300000,88360000,140467290
1418,TCP,ibm-mqseries,14470,676380,1750000,66560000,119120000,188120850
1522,TCP,oracle-tns,14460,1340000,2080000,65930000,116690000,186054460
3003,TCP,NCP,14430,613120,1590000,56020000,105430000,163667550
8031,TCP,SSLSessionReq,14180,1880000,1500000,7790000,102250000,113434180
1972,TCP,NotesRPC,14120,628270,1620000,60110000,110600000,172972390
32787,TCP,RPCCheck,14120,2240000,3380000,73920000,229270000,308824120
11965,TCP,GenericLines,14090,1370000,1660000,8630000,110530000,122204090
1212,TCP,GenericLines,14080,945260,1300000,6960000,98140000,107359340
1415,TCP,ibm-mqseries,14080,703120,1890000,67470000,125400000,195477200
3025,TCP,Hello,14080,884360,1840000,72770000,124590000,200098440
3005,TCP,GenericLines,14070,822860,1670000,8270000,106020000,116796930
7210,TCP,SSLSessionReq,14030,829290,1770000,71310000,125980000,199903320
1066,TCP,SSLSessionReq,13960,1190000,1460000,7660000,101590000,111913960
32779,TCP,RPCCheck,13940,711290,2140000,63420000,124110000,190395230
1,TCP,Help,13900,852550,1370000,7650000,107020000,116906450
1241,TCP,SSLSessionReq,13840,754710,1590000,7980000,107390000,117728550
60019,TCP,ibm-db2,13830,2060000,3990000,139940000,249730000,395733830
1419,TCP,ibm-mqseries,13610,1260000,1980000,63770000,112640000,179663610
1044,TCP,SSLSessionReq,13550,1440000,1530000,7640000,103800000,114423550
1416,TCP,ibm-mqseries,13500,672580,1790000,65930000,119670000,188076080
161,TCP,GetRequest,13490,479820,2510000,8080000,107820000,118903310
1049,TCP,SSLSessionReq,13420,1470000,1850000,7720000,103120000,114173420
7200,TCP,GenericLines,13390,1630000,1620000,8410000,107740000,119413390
1109,TCP,Socks4,13340,1200000,2140000,65520000,119260000,188133340
1074,TCP,SSLSessionReq,13290,944460,1570000,8470000,103880000,114877750
1583,TCP,pervasive-btrieve,13280,816380,1920000,71150000,126240000,200139660
32765,TCP,RPCCheck,13280,757160,1790000,69900000,122650000,195110440
1065,TCP,SSLSessionReq,13230,1410000,1730000,7900000,102650000,113703230
1527,TCP,drda,13220,684230,1730000,68140000,123190000,193757450
1042,TCP,GenericLines,13180,1240000,1490000,7920000,105590000,116253180
1064,TCP,SSLSessionReq,13170,968280,1470000,8060000,102560000,113071450
98,TCP,GenericLines,13140,862970,1330000,7790000,109310000,119306110
32778,TCP,RPCCheck,13130,1170000,1730000,7820000,102370000,113103130
1095,TCP,Socks4,13090,1210000,2170000,69240000,122770000,195403090
19350,TCP,LPDString,13090,1100000,1980000,70510000,123420000,197023090
1505,TCP,GenericLines,13020,1110000,1450000,7920000,106110000,116603020
1501,TCP,GenericLines,12980,866840,1240000,6260000,82390000,90769820
1036,TCP,SSLSessionReq,12970,938140,1470000,7090000,91590000,101101110
1058,TCP,SSLSessionReq,12900,1200000,1480000,7770000,101910000,112372900
1071,TCP,SSLSessionReq,12890,878280,1630000,7850000,103230000,113601170
1420,TCP,ibm-mqseries,12890,801090,1700000,64400000,118400000,185313980
3351,TCP,pervasive-relational,12820,942730,1910000,68990000,122340000,194195550
5400,TCP,GenericLines,12720,1340000,1510000,7750000,103130000,113742720
5600,TCP,SMBProgNeg,12720,746900,1740000,55490000,105590000,163579620
1059,TCP,SSLSessionReq,12690,1080000,1430000,7520000,102510000,112552690
1069,TCP,SSLSessionReq,12690,1120000,1500000,7620000,103110000,113362690
1433,TCP,RPCCheck,12580,547090,1530000,69740000,122530000,194359670
2427,TCP,RPCCheck,12540,542510,921040,8120000,110050000,119646090
1010,TCP,GenericLines,12460,879350,1360000,7280000,106830000,116361810
7272,TCP,SSLv23SessionReq,12440,882190,1700000,13400000,102090000,118084630
540,TCP,GenericLines,12420,988730,1300000,7500000,107040000,116841150
3940,TCP,GenericLines,12290,1160000,1460000,7590000,105930000,116152290
7272,TCP,SSLSessionReq,12280,877760,1620000,50030000,111750000,164290040
7171,TCP,NotesRPC,12220,731610,1720000,69580000,125010000,197053830
144,TCP,SSLSessionReq,12080,795920,1480000,7270000,102470000,112028000
3900,TCP,SMBProgNeg,12020,938500,1620000,8000000,110140000,120710520
1801,TCP,SSLSessionReq,11990,1020000,1530000,8280000,104890000,115731990
1998,TCP,SSLSessionReq,11930,1320000,1710000,8190000,105000000,116231930
50015,TCP,ibm-db2,11910,1260000,2960000,112320000,203570000,320121910
1400,TCP,GenericLines,11870,960090,1490000,7670000,104170000,114301960
27004,TCP,SMBProgNeg,11870,996480,1880000,59600000,120020000,182508350
43,TCP,GenericLines,11860,1230000,1560000,9190000,129000000,140991860
1302,TCP,GenericLines,11820,1510000,1620000,7950000,106050000,117141820
32752,TCP,RPCCheck,11770,866490,1810000,73730000,122640000,199058260
1043,TCP,GenericLines,11750,1270000,1590000,7800000,105440000,116111750
1526,TCP,oracle-tns,11710,1540000,2100000,66270000,119740000,189661710
111,TCP,SSLSessionReq,11700,1330000,1840000,6860000,102000000,112041700
1041,TCP,GenericLines,11700,1170000,1480000,7660000,104800000,115121700
1105,TCP,Socks5,11540,680320,1480000,50830000,95000000,148001860
32797,TCP,RPCCheck,11530,2100000,4030000,71700000,231000000,308841530
1105,TCP,Socks4,11520,782180,1520000,61700000,109260000,173273700
2947,TCP,LPDString,11460,726670,1730000,62150000,117420000,182038130
3986,TCP,SSLSessionReq,11330,1020000,1550000,7990000,105100000,115671330
7101,TCP,X11Probe,11330,813510,1580000,63530000,114670000,180604840
8138,TCP,GenericLines,11300,1070000,1840000,8490000,108410000,119821300
27008,TCP,SMBProgNeg,11270,921010,1720000,68860000,120590000,192102280
1702,TCP,LDAPBindReq,11260,707460,1870000,66260000,124780000,193628720
7938,TCP,SSLSessionReq,11210,1090000,1490000,7930000,105600000,116121210
32755,TCP,RPCCheck,11190,1010000,1800000,72220000,123130000,198171190
17007,TCP,RPCCheck,11140,772310,1800000,76670000,125260000,204513450
4899,TCP,Radmin,11120,1250000,1880000,65680000,120010000,188831120
60004,TCP,ibm-db2,11120,704630,1930000,66260000,123710000,192615750
1574,TCP,oracle-tns,11090,1280000,2130000,68950000,123190000,195561090
1068,TCP,TerminalServer,11080,634270,1760000,59250000,127880000,189535350
32211,TCP,LPDString,11070,844980,1740000,74220000,122860000,199676050
3632,TCP,DistCCD,11060,693170,1720000,69160000,124130000,195714230
3703,TCP,SSLSessionReq,11030,1240000,1490000,7830000,103920000,114491030
255,TCP,GetRequest,11010,357680,583570,2970000,44610000,48532260
19150,TCP,GenericLines,10980,893620,2100000,8560000,111180000,122744600
1526,TCP,drda,10970,1750000,2250000,68210000,123710000,195930970
32768,TCP,SSLSessionReq,10940,1210000,1550000,7520000,102070000,112360940
7937,TCP,SSLSessionReq,10930,1370000,1520000,7890000,103510000,114300930
1467,TCP,GenericLines,10920,1210000,1510000,8070000,106210000,117010920
1666,TCP,GenericLines,10900,1080000,1440000,7810000,106000000,116340900
31416,TCP,GenericLines,10880,1210000,1510000,7910000,110490000,121130880
9481,TCP,Socks5,10840,554740,1180000,45260000,81450000,128455580
1090,TCP,Socks4,10820,532630,1210000,47000000,89660000,138413450
22490,TCP,Help,10820,678310,1530000,8050000,106940000,117209130
1503,TCP,TerminalServer,10720,617780,1590000,54470000,101420000,158108500
1763,TCP,LANDesk-RC,10690,709120,1840000,68420000,123450000,194429810
32780,TCP,RPCCheck,10680,1520000,1540000,7850000,104040000,114960680
32753,TCP,RPCCheck,10610,727720,1760000,65390000,122710000,190598330
4369,TCP,epmd,10600,488730,1390000,46860000,82730000,131479330
5323,TCP,DNSVersionBindReq,10550,1170000,1950000,64120000,116720000,183970550
11371,TCP,GenericLines,10540,1640000,1850000,8310000,109750000,121560540
11210,TCP,couchbase-data,10530,643030,1540000,62690000,108170000,173053560
13783,TCP,DNSVersionBindReq,10510,1160000,1640000,7920000,110240000,120970510
27003,TCP,SMBProgNeg,10510,641150,1600000,57300000,107420000,166971660
427,TCP,NotesRPC,10480,748330,1550000,70940000,126450000,199698810
1550,TCP,X11Probe,10480,683340,1750000,64570000,122450000,189463820
1220,TCP,GenericLines,10450,827220,800820,4350000,57870000,63858490
32763,TCP,RPCCheck,10450,745440,1890000,63390000,122740000,188775890
1688,TCP,GenericLines,10440,1250000,1440000,6820000,97560000,107080440
27010,TCP,SMBProgNeg,10420,840830,1770000,52440000,104860000,159921250
616,TCP,GenericLines,10380,818750,1350000,7590000,105570000,115339130
37435,TCP,HTTPOptions,10370,500740,1130000,47300000,83860000,132801110
32807,TCP,RPCCheck,10350,1850000,3500000,74190000,231700000,311250350
8333,TCP,RPCCheck,10330,1140000,1870000,7990000,102540000,113550330
32762,TCP,RPCCheck,10300,786640,1790000,70720000,122520000,195826940
60003,TCP,ibm-db2,10290,567870,1700000,53570000,100510000,156358160
27002,TCP,SMBProgNeg,10280,855110,1810000,23620000,94720000,121015390
32756,TCP,RPCCheck,10220,736830,1780000,65470000,123910000,191907050
13720,TCP,GenericLines,10180,784910,1560000,8530000,110220000,121105090
1432,TCP,GenericLines,10160,1030000,1440000,7710000,104440000,114630160
5302,TCP,X11Probe,10110,663860,1590000,61860000,113520000,177643970
27009,TCP,SMBProgNeg,10040,662330,1610000,57020000,108210000,167512370
14238,TCP,oracle-tns,10020,700400,1860000,65780000,125230000,193580420
510,TCP,GenericLines,9980,852790,1280000,7340000,105000000,114482770
524,TCP,NCP,9940,606800,1630000,60820000,111780000,174846740
30444,TCP,GenericLines,9940,1040000,1580000,8060000,109360000,120049940
1039,TCP,SSLSessionReq,9920,934370,1260000,5540000,75150000,82894290
27005,TCP,SMBProgNeg,9910,642240,1440000,54450000,102500000,159042150
1762,TCP,LANDesk-RC,9870,657620,1670000,62500000,113610000,178447490
26214,TCP,GenericLines,9810,902520,1720000,8200000,109460000,120292330
32782,TCP,RPCCheck,9760,688200,1840000,65400000,122540000,190477960
26470,TCP,GenericLines,9740,901650,1560000,8180000,109050000,119701390
32754,TCP,RPCCheck,9710,719110,1700000,71430000,117650000,191508820
7461,TCP,SMBProgNeg,9700,1250000,1610000,45710000,106350000,154929700
710,TCP,RPCCheck,9650,787320,1310000,7480000,103480000,113066970
50006,TCP,ibm-db2,9600,701110,1670000,64730000,120240000,187350710
1549,TCP,WMSRequest,9590,605290,1570000,56450000,106220000,164854880
27006,TCP,SMBProgNeg,9580,857380,1550000,55810000,104730000,162956960
60010,TCP,ibm-db2,9490,792840,1730000,72020000,121850000,196402330
32766,TCP,RPCCheck,9370,695450,1780000,59260000,114810000,176554820
32781,TCP,RPCCheck,9260,1340000,1650000,7800000,105180000,115979260
50023,TCP,ibm-db2,9140,712710,1820000,67440000,122820000,192801850
27007,TCP,SMBProgNeg,9110,572870,1460000,51240000,95960000,149241980
32803,TCP,RPCCheck,9040,683210,1870000,66130000,124660000,193352250
3493,TCP,Help,9030,606640,1290000,48230000,86560000,136695670
543,TCP,SSLSessionReq,9010,755190,1280000,7330000,102490000,111864200
50008,TCP,ibm-db2,9000,836220,1720000,70140000,123320000,196025220
60007,TCP,ibm-db2,8810,760320,1880000,69090000,126980000,198719130
1053,TCP,SSLSessionReq,8790,731210,954150,4930000,69110000,75734150
60006,TCP,ibm-db2,8790,700680,2180000,66820000,124320000,194029470
32759,TCP,RPCCheck,8690,632520,1530000,56460000,105810000,164441210
32751,TCP,RPCCheck,8680,891770,1500000,8100000,105190000,115690450
32784,TCP,RPCCheck,8640,701990,1860000,65750000,123490000,191810630
32758,TCP,RPCCheck,8630,1320000,1490000,7800000,103720000,114338630
543,TCP,DNSVersionBindReq,8600,1160000,1790000,69340000,121000000,193298600
32760,TCP,RPCCheck,8520,1130000,1500000,7730000,103040000,113408520
32761,TCP,RPCCheck,8480,1640000,1740000,7690000,104420000,115498480
32783,TCP,RPCCheck,8380,684540,1900000,66220000,123730000,192542920
32750,TCP,RPCCheck,8370,1330000,1450000,7660000,102500000,112948370
50007,TCP,ibm-db2,8250,714490,1730000,68470000,124080000,195002740
3892,TCP,LDAPBindReq,8160,616850,1500000,53830000,101110000,157065010
50021,TCP,ibm-db2,7980,960020,1600000,60200000,105870000,168638000
32771,TCP,SSLSessionReq,7970,1290000,1930000,7770000,102330000,113327970
255,TCP,SSLSessionReq,7940,649940,1280000,6820000,101190000,109947880
50010,TCP,ibm-db2,7900,573020,1370000,49590000,93690000,145230920
4868,TCP,EMPTY PROBE,7890,891400,1350000,8080000,106850000,117179290
544,TCP,SSLSessionReq,7880,724620,1260000,7360000,102950000,112302500
50012,TCP,ibm-db2,7830,746050,1870000,65730000,123770000,192123880
50011,TCP,ibm-db2,7780,1080000,1720000,57680000,103950000,164437780
50017,TCP,ibm-db2,7760,807080,1820000,68330000,123620000,194584840
32786,TCP,RPCCheck,7750,687410,1890000,66070000,123840000,192495160
60012,TCP,ibm-db2,7750,770170,1740000,70400000,122550000,195467920
6646,TCP,SSLSessionReq,7730,883790,1020000,4730000,60760000,67401520
3,TCP,SSLSessionReq,7700,754600,1470000,7780000,112840000,122852300
60020,TCP,ibm-db2,7670,730920,1690000,71090000,118390000,191908590
60025,TCP,ibm-db2,7670,756030,1790000,69080000,125870000,197503700
214,TCP,GenericLines,7660,998450,1660000,9520000,134320000,146506110
464,TCP,SSLSessionReq,7660,871340,1290000,7290000,102190000,111649000
35,TCP,GenericLines,7620,833360,1470000,7630000,107510000,117450980
50009,TCP,ibm-db2,7590,690520,1630000,58410000,111240000,171978110
44,TCP,SSLSessionReq,7460,534810,849370,8000000,108590000,117981640
32785,TCP,RPCCheck,7430,641260,1720000,60430000,113350000,176148690
32800,TCP,RPCCheck,7340,1200000,1430000,7880000,105080000,115597340
464,TCP,GetRequest,7320,265210,382940,2300000,32850000,35805470
60013,TCP,ibm-db2,7270,713190,1850000,67640000,124900000,195110460
50016,TCP,ibm-db2,7230,723890,1790000,70110000,126350000,198981120
9,TCP,SSLSessionReq,7160,1000000,1560000,7570000,108380000,118517160
60024,TCP,ibm-db2,7160,670520,1650000,61100000,113190000,176617680
60011,TCP,ibm-db2,7110,1160000,1970000,63020000,115370000,181527110
50014,TCP,ibm-db2,7100,821970,1800000,68310000,124920000,195859070
60015,TCP,ibm-db2,6970,674750,1670000,67170000,120810000,190331720
625,TCP,SSLSessionReq,6870,686070,1480000,7210000,102960000,112342940
50018,TCP,ibm-db2,6850,777220,1690000,76710000,121760000,200944070
711,TCP,RPCCheck,6820,723450,1550000,7740000,104230000,114250270
50020,TCP,ibm-db2,6790,725810,1690000,60680000,114500000,177602600
60008,TCP,ibm-db2,6770,1080000,1870000,59530000,109000000,171486770
50004,TCP,ibm-db2,6680,681460,1270000,45130000,82940000,130028140
50019,TCP,ibm-db2,6640,772160,1850000,65240000,123750000,191618800
41523,TCP,DNSStatusRequest,6600,1240000,1800000,8100000,108090000,119236600
135,TCP,DNSVersionBindReq,6580,309370,533070,21110000,110660000,132619020
32789,TCP,RPCCheck,6580,1680000,1500000,7660000,102200000,113046580
50024,TCP,ibm-db2,6570,968420,1960000,66390000,121350000,190674990
60017,TCP,ibm-db2,6570,731300,1680000,68290000,123960000,194667870
50013,TCP,ibm-db2,6530,712880,1830000,62350000,117540000,182439410
60018,TCP,ibm-db2,6530,681270,1710000,69250000,124990000,196637800
60016,TCP,ibm-db2,6510,693410,1870000,66760000,125330000,194659920
60014,TCP,ibm-db2,6490,688550,1700000,63200000,114680000,180275040
32788,TCP,RPCCheck,6420,1820000,1680000,8100000,103730000,115336420
544,TCP,RPCCheck,6350,749160,1540000,72650000,124700000,199645510
32792,TCP,RPCCheck,6300,622860,1630000,55710000,105870000,163839160
32793,TCP,RPCCheck,6200,683890,2160000,66620000,123970000,193440090
32794,TCP,RPCCheck,6190,712000,1920000,66710000,124110000,193458190
32790,TCP,RPCCheck,6080,1180000,1780000,8100000,106030000,117096080
505,TCP,GenericLines,6010,729340,1370000,7590000,106090000,115785350
32801,TCP,RPCCheck,5980,1120000,1450000,7710000,105470000,115755980
34012,TCP,GenericLines,5960,955330,1520000,8060000,108980000,119521290
782,TCP,GenericLines,5860,834870,1290000,7320000,106660000,116110730
32791,TCP,RPCCheck,5770,1400000,1430000,7820000,104860000,115515770
628,TCP,GenericLines,5740,937730,1370000,7450000,106060000,115823470
32804,TCP,RPCCheck,5720,690480,2030000,66520000,125030000,194276200
56667,TCP,GenericLines,5650,1220000,1590000,8130000,110150000,121095650
390,TCP,LDAPBindReq,5630,1170000,1930000,69660000,125050000,197815630
32805,TCP,RPCCheck,5620,716450,1900000,63820000,123140000,189582070
32799,TCP,RPCCheck,5560,1010000,1740000,8760000,110970000,122485560
55553,TCP,metasploit-xmlrpc,5560,682310,1860000,67530000,123210000,193287870
32802,TCP,RPCCheck,5430,612420,1620000,54730000,105630000,162597850
33015,TCP,tarantool,5430,1180000,2020000,64260000,116210000,183675430
1687,TCP,GenericLines,5330,695690,801820,4120000,55920000,61542840
32806,TCP,RPCCheck,5330,688940,1870000,67610000,125560000,195734270
731,TCP,GenericLines,5210,765710,1330000,7640000,105710000,115450920
130,TCP,NotesRPC,5070,674520,1570000,62840000,118940000,184029590
32798,TCP,RPCCheck,5060,1280000,1630000,8290000,105900000,117105060
32809,TCP,RPCCheck,5020,1050000,1670000,8370000,108640000,119735020
660,TCP,SMBProgNeg,4930,771890,1230000,36480000,96410000,134896820
32796,TCP,RPCCheck,4910,578050,2080000,55740000,103040000,161442960
32810,TCP,RPCCheck,4820,1570000,1600000,8000000,104520000,115694820
706,TCP,JavaRMI,4780,1110000,1830000,67870000,120880000,191694780
32808,TCP,RPCCheck,4780,1440000,1570000,7840000,104390000,115244780
628,TCP,DNSVersionBindReq,4680,699320,1490000,7990000,107550000,117734000
32795,TCP,RPCCheck,4460,547800,1450000,49040000,93430000,144472260
38978,TCP,RPCCheck,4420,1070000,1410000,8070000,104900000,115454420
257,TCP,LDAPBindReq,3860,432650,1000000,39090000,75440000,115966510
